npcs=Ian, Keith
Ian.position=4, 4

[ ####  ###   ]
[ #  #  # #   ]
[ #  #  # #   ]
[ #  #  # #   ]
[ ####  ###   ]
[  #          ]
[~~~~~~~~~~~~ ]
[~~~~~~~~~~~~ ]
[~~~~~~~~~~~~ ]
[~~~~~~~~~~~~ ]
[       h     ]
[             ]
