
[ |-|     |   ]
[ | |     |   ]
[ | |     |   ]
[ | |     |   ]
[ |-|     |   ]
[ |-|     |   ]
[~~~~~~~~~~~~ ]
[~~~~~~~~~~~~ ]
[~~~~~~~~~~~~ ]
[~~~~~~~~~~~~ ]
[       h     ]
[             ]
