
[  #    ###   ]
[  #    # #   ]
[  #    # #   ]
[  #    # #   ]
[  #    # #   ]
[  #    ###   ]
[      ~~~~   ]
[      ~h~~   ]
[      ~~~~   ]
[             ]
[             ]
[             ]
